DDDWMJP | DDDWMJQ | DDDWMJR | DDDWMJS | DDDWMKP | DDDWMKQ | DDDWMKR | DDDWMKS | DDDWMLP | DDDWMLQ | DDDWMLR
DDDWMLS | DDDWNJP | DDDWNJQ | DDDWNJR | DDDWNJS | DDDWNKP | DDDWNKQ | DDDWNKR | DDDWNKS | DDDWNLP | DDDWNLQ
DDDWNLR | DDDWNLS | DDDWOJP | DDDWOJQ | DDDWOJR | DDDWOJS | DDDWOKP | DDDWOKQ | DDDWOKR | DDDWOKS | DDDWOLP
DDDWOLQ | DDDWOLR | DDDWOLS | DDDXMJP | DDDXMJQ | DDDXMJR | DDDXMJS | DDDXMKP | DDDXMKQ | DDDXMKR | DDDXMKS
DDDXMLP | DDDXMLQ | DDDXMLR | DDDXMLS | DDDXNJP | DDDXNJQ | DDDXNJR | DDDXNJS | DDDXNKP | DDDXNKQ | DDDXNKR
DDDXNKS | DDDXNLP | DDDXNLQ | DDDXNLR | DDDXNLS | DDDXOJP | DDDXOJQ | DDDXOJR | DDDXOJS | DDDXOKP | DDDXOKQ
DDDXOKR | DDDXOKS | DDDXOLP | DDDXOLQ | DDDXOLR | DDDXOLS | DDDYMJP | DDDYMJQ | DDDYMJR | DDDYMJS | DDDYMKP
DDDYMKQ | DDDYMKR | DDDYMKS | DDDYMLP | DDDYMLQ | DDDYMLR | DDDYMLS | DDDYNJP | DDDYNJQ | DDDYNJR | DDDYNJS
DDDYNKP | DDDYNKQ | DDDYNKR | DDDYNKS | DDDYNLP | DDDYNLQ | DDDYNLR | DDDYNLS | DDDYOJP | DDDYOJQ | DDDYOJR
DDDYOJS | DDDYOKP | DDDYOKQ | DDDYOKR | DDDYOKS | DDDYOLP | DDDYOLQ | DDDYOLR | DDDYOLS | DDDZMJP | DDDZMJQ
DDDZMJR | DDDZMJS | DDDZMKP | DDDZMKQ | DDDZMKR | DDDZMKS | DDDZMLP | DDDZMLQ | DDDZMLR | DDDZMLS | DDDZNJP
DDDZNJQ | DDDZNJR | DDDZNJS | DDDZNKP | DDDZNKQ | DDDZNKR | DDDZNKS | DDDZNLP | DDDZNLQ | DDDZNLR | DDDZNLS
DDDZOJP | DDDZOJQ | DDDZOJR | DDDZOJS | DDDZOKP | DDDZOKQ | DDDZOKR | DDDZOKS | DDDZOLP | DDDZOLQ | DDDZOLR
DDDZOLS | DDEWMJP | DDEWMJQ | DDEWMJR | DDEWMJS | DDEWMKP | DDEWMKQ | DDEWMKR | DDEWMKS | DDEWMLP | DDEWMLQ
DDEWMLR | DDEWMLS | DDEWNJP | DDEWNJQ | DDEWNJR | DDEWNJS | DDEWNKP | DDEWNKQ | DDEWNKR | DDEWNKS | DDEWNLP
DDEWNLQ | DDEWNLR | DDEWNLS | DDEWOJP | DDEWOJQ | DDEWOJR | DDEWOJS | DDEWOKP | DDEWOKQ | DDEWOKR | DDEWOKS
DDEWOLP | DDEWOLQ | DDEWOLR | DDEWOLS | DDEXMJP | DDEXMJQ | DDEXMJR | DDEXMJS | DDEXMKP | DDEXMKQ | DDEXMKR
DDEXMKS | DDEXMLP | DDEXMLQ | DDEXMLR | DDEXMLS | DDEXNJP | DDEXNJQ | DDEXNJR | DDEXNJS | DDEXNKP | DDEXNKQ
DDEXNKR | DDEXNKS | DDEXNLP | DDEXNLQ | DDEXNLR | DDEXNLS | DDEXOJP | DDEXOJQ | DDEXOJR | DDEXOJS | DDEXOKP
DDEXOKQ | DDEXOKR | DDEXOKS | DDEXOLP | DDEXOLQ | DDEXOLR | DDEXOLS | DDEYMJP | DDEYMJQ | DDEYMJR | DDEYMJS
DDEYMKP | DDEYMKQ | DDEYMKR | DDEYMKS | DDEYMLP | DDEYMLQ | DDEYMLR | DDEYMLS | DDEYNJP | DDEYNJQ | DDEYNJR
DDEYNJS | DDEYNKP | DDEYNKQ | DDEYNKR | DDEYNKS | DDEYNLP | DDEYNLQ | DDEYNLR | DDEYNLS | DDEYOJP | DDEYOJQ
DDEYOJR | DDEYOJS | DDEYOKP | DDEYOKQ | DDEYOKR | DDEYOKS | DDEYOLP | DDEYOLQ | DDEYOLR | DDEYOLS | DDEZMJP
DDEZMJQ | DDEZMJR | DDEZMJS | DDEZMKP | DDEZMKQ | DDEZMKR | DDEZMKS | DDEZMLP | DDEZMLQ | DDEZMLR | DDEZMLS
DDEZNJP | DDEZNJQ | DDEZNJR | DDEZNJS | DDEZNKP | DDEZNKQ | DDEZNKR | DDEZNKS | DDEZNLP | DDEZNLQ | DDEZNLR
DDEZNLS | DDEZOJP | DDEZOJQ | DDEZOJR | DDEZOJS | DDEZOKP | DDEZOKQ | DDEZOKR | DDEZOKS | DDEZOLP | DDEZOLQ
DDEZOLR | DDEZOLS | DDFWMJP | DDFWMJQ | DDFWMJR | DDFWMJS | DDFWMKP | DDFWMKQ | DDFWMKR | DDFWMKS | DDFWMLP
DDFWMLQ | DDFWMLR | DDFWMLS | DDFWNJP | DDFWNJQ | DDFWNJR | DDFWNJS | DDFWNKP | DDFWNKQ | DDFWNKR | DDFWNKS
DDFWNLP | DDFWNLQ | DDFWNLR | DDFWNLS | DDFWOJP | DDFWOJQ | DDFWOJR | DDFWOJS | DDFWOKP | DDFWOKQ | DDFWOKR
DDFWOKS | DDFWOLP | DDFWOLQ | DDFWOLR | DDFWOLS | DDFXMJP | DDFXMJQ | DDFXMJR | DDFXMJS | DDFXMKP | DDFXMKQ
DDFXMKR | DDFXMKS | DDFXMLP | DDFXMLQ | DDFXMLR | DDFXMLS | DDFXNJP | DDFXNJQ | DDFXNJR | DDFXNJS | DDFXNKP
DDFXNKQ | DDFXNKR | DDFXNKS | DDFXNLP | DDFXNLQ | DDFXNLR | DDFXNLS | DDFXOJP | DDFXOJQ | DDFXOJR | DDFXOJS
DDFXOKP | DDFXOKQ | DDFXOKR | DDFXOKS | DDFXOLP | DDFXOLQ | DDFXOLR | DDFXOLS | DDFYMJP | DDFYMJQ | DDFYMJR
DDFYMJS | DDFYMKP | DDFYMKQ | DDFYMKR | DDFYMKS | DDFYMLP | DDFYMLQ | DDFYMLR | DDFYMLS | DDFYNJP | DDFYNJQ
DDFYNJR | DDFYNJS | DDFYNKP | DDFYNKQ | DDFYNKR | DDFYNKS | DDFYNLP | DDFYNLQ | DDFYNLR | DDFYNLS | DDFYOJP
DDFYOJQ | DDFYOJR | DDFYOJS | DDFYOKP | DDFYOKQ | DDFYOKR | DDFYOKS | DDFYOLP | DDFYOLQ | DDFYOLR | DDFYOLS
DDFZMJP | DDFZMJQ | DDFZMJR | DDFZMJS | DDFZMKP | DDFZMKQ | DDFZMKR | DDFZMKS | DDFZMLP | DDFZMLQ | DDFZMLR
DDFZMLS | DDFZNJP | DDFZNJQ | DDFZNJR | DDFZNJS | DDFZNKP | DDFZNKQ | DDFZNKR | DDFZNKS | DDFZNLP | DDFZNLQ
DDFZNLR | DDFZNLS | DDFZOJP | DDFZOJQ | DDFZOJR | DDFZOJS | DDFZOKP | DDFZOKQ | DDFZOKR | DDFZOKS | DDFZOLP
DDFZOLQ | DDFZOLR | DDFZOLS | DEDWMJP | DEDWMJQ | DEDWMJR | DEDWMJS | DEDWMKP | DEDWMKQ | DEDWMKR | DEDWMKS
DEDWMLP | DEDWMLQ | DEDWMLR | DEDWMLS | DEDWNJP | DEDWNJQ | DEDWNJR | DEDWNJS | DEDWNKP | DEDWNKQ | DEDWNKR
DEDWNKS | DEDWNLP | DEDWNLQ | DEDWNLR | DEDWNLS | DEDWOJP | DEDWOJQ | DEDWOJR | DEDWOJS | DEDWOKP | DEDWOKQ
DEDWOKR | DEDWOKS | DEDWOLP | DEDWOLQ | DEDWOLR | DEDWOLS | DEDXMJP | DEDXMJQ | DEDXMJR | DEDXMJS | DEDXMKP
DEDXMKQ | DEDXMKR | DEDXMKS | DEDXMLP | DEDXMLQ | DEDXMLR | DEDXMLS | DEDXNJP | DEDXNJQ | DEDXNJR | DEDXNJS
DEDXNKP | DEDXNKQ | DEDXNKR | DEDXNKS | DEDXNLP | DEDXNLQ | DEDXNLR | DEDXNLS | DEDXOJP | DEDXOJQ | DEDXOJR
DEDXOJS | DEDXOKP | DEDXOKQ | DEDXOKR | DEDXOKS | DEDXOLP | DEDXOLQ | DEDXOLR | DEDXOLS | DEDYMJP | DEDYMJQ
DEDYMJR | DEDYMJS | DEDYMKP | DEDYMKQ | DEDYMKR | DEDYMKS | DEDYMLP | DEDYMLQ | DEDYMLR | DEDYMLS | DEDYNJP
DEDYNJQ | DEDYNJR | DEDYNJS | DEDYNKP | DEDYNKQ | DEDYNKR | DEDYNKS | DEDYNLP | DEDYNLQ | DEDYNLR | DEDYNLS
DEDYOJP | DEDYOJQ | DEDYOJR | DEDYOJS | DEDYOKP | DEDYOKQ | DEDYOKR | DEDYOKS | DEDYOLP | DEDYOLQ | DEDYOLR
DEDYOLS | DEDZMJP | DEDZMJQ | DEDZMJR | DEDZMJS | DEDZMKP | DEDZMKQ | DEDZMKR | DEDZMKS | DEDZMLP | DEDZMLQ
DEDZMLR | DEDZMLS | DEDZNJP | DEDZNJQ | DEDZNJR | DEDZNJS | DEDZNKP | DEDZNKQ | DEDZNKR | DEDZNKS | DEDZNLP
DEDZNLQ | DEDZNLR | DEDZNLS | DEDZOJP | DEDZOJQ | DEDZOJR | DEDZOJS | DEDZOKP | DEDZOKQ | DEDZOKR | DEDZOKS
DEDZOLP | DEDZOLQ | DEDZOLR | DEDZOLS | DEEWMJP | DEEWMJQ | DEEWMJR | DEEWMJS | DEEWMKP | DEEWMKQ | DEEWMKR
DEEWMKS | DEEWMLP | DEEWMLQ | DEEWMLR | DEEWMLS | DEEWNJP | DEEWNJQ | DEEWNJR | DEEWNJS | DEEWNKP | DEEWNKQ
DEEWNKR | DEEWNKS | DEEWNLP | DEEWNLQ | DEEWNLR | DEEWNLS | DEEWOJP | DEEWOJQ | DEEWOJR | DEEWOJS | DEEWOKP
DEEWOKQ | DEEWOKR | DEEWOKS | DEEWOLP | DEEWOLQ | DEEWOLR | DEEWOLS | DEEXMJP | DEEXMJQ | DEEXMJR | DEEXMJS
DEEXMKP | DEEXMKQ | DEEXMKR | DEEXMKS | DEEXMLP | DEEXMLQ | DEEXMLR | DEEXMLS | DEEXNJP | DEEXNJQ | DEEXNJR
DEEXNJS | DEEXNKP | DEEXNKQ | DEEXNKR | DEEXNKS | DEEXNLP | DEEXNLQ | DEEXNLR | DEEXNLS | DEEXOJP | DEEXOJQ
DEEXOJR | DEEXOJS | DEEXOKP | DEEXOKQ | DEEXOKR | DEEXOKS | DEEXOLP | DEEXOLQ | DEEXOLR | DEEXOLS | DEEYMJP
DEEYMJQ | DEEYMJR | DEEYMJS | DEEYMKP | DEEYMKQ | DEEYMKR | DEEYMKS | DEEYMLP | DEEYMLQ | DEEYMLR | DEEYMLS
DEEYNJP | DEEYNJQ | DEEYNJR | DEEYNJS | DEEYNKP | DEEYNKQ | DEEYNKR | DEEYNKS | DEEYNLP | DEEYNLQ | DEEYNLR
DEEYNLS | DEEYOJP | DEEYOJQ | DEEYOJR | DEEYOJS | DEEYOKP | DEEYOKQ | DEEYOKR | DEEYOKS | DEEYOLP | DEEYOLQ
DEEYOLR | DEEYOLS | DEEZMJP | DEEZMJQ | DEEZMJR | DEEZMJS | DEEZMKP | DEEZMKQ | DEEZMKR | DEEZMKS | DEEZMLP
DEEZMLQ | DEEZMLR | DEEZMLS | DEEZNJP | DEEZNJQ | DEEZNJR | DEEZNJS | DEEZNKP | DEEZNKQ | DEEZNKR | DEEZNKS
DEEZNLP | DEEZNLQ | DEEZNLR | DEEZNLS | DEEZOJP | DEEZOJQ | DEEZOJR | DEEZOJS | DEEZOKP | DEEZOKQ | DEEZOKR
DEEZOKS | DEEZOLP | DEEZOLQ | DEEZOLR | DEEZOLS | DEFWMJP | DEFWMJQ | DEFWMJR | DEFWMJS | DEFWMKP | DEFWMKQ
DEFWMKR | DEFWMKS | DEFWMLP | DEFWMLQ | DEFWMLR | DEFWMLS | DEFWNJP | DEFWNJQ | DEFWNJR | DEFWNJS | DEFWNKP
DEFWNKQ | DEFWNKR | DEFWNKS | DEFWNLP | DEFWNLQ | DEFWNLR | DEFWNLS | DEFWOJP | DEFWOJQ | DEFWOJR | DEFWOJS
DEFWOKP | DEFWOKQ | DEFWOKR | DEFWOKS | DEFWOLP | DEFWOLQ | DEFWOLR | DEFWOLS | DEFXMJP | DEFXMJQ | DEFXMJR
DEFXMJS | DEFXMKP | DEFXMKQ | DEFXMKR | DEFXMKS | DEFXMLP | DEFXMLQ | DEFXMLR | DEFXMLS | DEFXNJP | DEFXNJQ
DEFXNJR | DEFXNJS | DEFXNKP | DEFXNKQ | DEFXNKR | DEFXNKS | DEFXNLP | DEFXNLQ | DEFXNLR | DEFXNLS | DEFXOJP
DEFXOJQ | DEFXOJR | DEFXOJS | DEFXOKP | DEFXOKQ | DEFXOKR | DEFXOKS | DEFXOLP | DEFXOLQ | DEFXOLR | DEFXOLS
DEFYMJP | DEFYMJQ | DEFYMJR | DEFYMJS | DEFYMKP | DEFYMKQ | DEFYMKR | DEFYMKS | DEFYMLP | DEFYMLQ | DEFYMLR
DEFYMLS | DEFYNJP | DEFYNJQ | DEFYNJR | DEFYNJS | DEFYNKP | DEFYNKQ | DEFYNKR | DEFYNKS | DEFYNLP | DEFYNLQ
DEFYNLR | DEFYNLS | DEFYOJP | DEFYOJQ | DEFYOJR | DEFYOJS | DEFYOKP | DEFYOKQ | DEFYOKR | DEFYOKS | DEFYOLP
DEFYOLQ | DEFYOLR | DEFYOLS | DEFZMJP | DEFZMJQ | DEFZMJR | DEFZMJS | DEFZMKP | DEFZMKQ | DEFZMKR | DEFZMKS
DEFZMLP | DEFZMLQ | DEFZMLR | DEFZMLS | DEFZNJP | DEFZNJQ | DEFZNJR | DEFZNJS | DEFZNKP | DEFZNKQ | DEFZNKR
DEFZNKS | DEFZNLP | DEFZNLQ | DEFZNLR | DEFZNLS | DEFZOJP | DEFZOJQ | DEFZOJR | DEFZOJS | DEFZOKP | DEFZOKQ
DEFZOKR | DEFZOKS | DEFZOLP | DEFZOLQ | DEFZOLR | DEFZOLS | DFDWMJP | DFDWMJQ | DFDWMJR | DFDWMJS | DFDWMKP
DFDWMKQ | DFDWMKR | DFDWMKS | DFDWMLP | DFDWMLQ | DFDWMLR | DFDWMLS | DFDWNJP | DFDWNJQ | DFDWNJR | DFDWNJS
DFDWNKP | DFDWNKQ | DFDWNKR | DFDWNKS | DFDWNLP | DFDWNLQ | DFDWNLR | DFDWNLS | DFDWOJP | DFDWOJQ | DFDWOJR
DFDWOJS | DFDWOKP | DFDWOKQ | DFDWOKR | DFDWOKS | DFDWOLP | DFDWOLQ | DFDWOLR | DFDWOLS | DFDXMJP | DFDXMJQ
DFDXMJR | DFDXMJS | DFDXMKP | DFDXMKQ | DFDXMKR | DFDXMKS | DFDXMLP | DFDXMLQ | DFDXMLR | DFDXMLS | DFDXNJP
DFDXNJQ | DFDXNJR | DFDXNJS | DFDXNKP | DFDXNKQ | DFDXNKR | DFDXNKS | DFDXNLP | DFDXNLQ | DFDXNLR | DFDXNLS
DFDXOJP | DFDXOJQ | DFDXOJR | DFDXOJS | DFDXOKP | DFDXOKQ | DFDXOKR | DFDXOKS | DFDXOLP | DFDXOLQ | DFDXOLR
DFDXOLS | DFDYMJP | DFDYMJQ | DFDYMJR | DFDYMJS | DFDYMKP | DFDYMKQ | DFDYMKR | DFDYMKS | DFDYMLP | DFDYMLQ
DFDYMLR | DFDYMLS | DFDYNJP | DFDYNJQ | DFDYNJR | DFDYNJS | DFDYNKP | DFDYNKQ | DFDYNKR | DFDYNKS | DFDYNLP
DFDYNLQ | DFDYNLR | DFDYNLS | DFDYOJP | DFDYOJQ | DFDYOJR | DFDYOJS | DFDYOKP | DFDYOKQ | DFDYOKR | DFDYOKS
DFDYOLP | DFDYOLQ | DFDYOLR | DFDYOLS | DFDZMJP | DFDZMJQ | DFDZMJR | DFDZMJS | DFDZMKP | DFDZMKQ | DFDZMKR
DFDZMKS | DFDZMLP | DFDZMLQ | DFDZMLR | DFDZMLS | DFDZNJP | DFDZNJQ | DFDZNJR | DFDZNJS | DFDZNKP | DFDZNKQ
DFDZNKR | DFDZNKS | DFDZNLP | DFDZNLQ | DFDZNLR | DFDZNLS | DFDZOJP | DFDZOJQ | DFDZOJR | DFDZOJS | DFDZOKP
DFDZOKQ | DFDZOKR | DFDZOKS | DFDZOLP | DFDZOLQ | DFDZOLR | DFDZOLS | DFEWMJP | DFEWMJQ | DFEWMJR | DFEWMJS
DFEWMKP | DFEWMKQ | DFEWMKR | DFEWMKS | DFEWMLP | DFEWMLQ | DFEWMLR | DFEWMLS | DFEWNJP | DFEWNJQ | DFEWNJR
DFEWNJS | DFEWNKP | DFEWNKQ | DFEWNKR | DFEWNKS | DFEWNLP | DFEWNLQ | DFEWNLR | DFEWNLS | DFEWOJP | DFEWOJQ
DFEWOJR | DFEWOJS | DFEWOKP | DFEWOKQ | DFEWOKR | DFEWOKS | DFEWOLP | DFEWOLQ | DFEWOLR | DFEWOLS | DFEXMJP
DFEXMJQ | DFEXMJR | DFEXMJS | DFEXMKP | DFEXMKQ | DFEXMKR | DFEXMKS | DFEXMLP | DFEXMLQ | DFEXMLR | DFEXMLS
DFEXNJP | DFEXNJQ | DFEXNJR | DFEXNJS | DFEXNKP | DFEXNKQ | DFEXNKR | DFEXNKS | DFEXNLP | DFEXNLQ | DFEXNLR
DFEXNLS | DFEXOJP | DFEXOJQ | DFEXOJR | DFEXOJS | DFEXOKP | DFEXOKQ | DFEXOKR | DFEXOKS | DFEXOLP | DFEXOLQ
DFEXOLR | DFEXOLS | DFEYMJP | DFEYMJQ | DFEYMJR | DFEYMJS | DFEYMKP | DFEYMKQ | DFEYMKR | DFEYMKS | DFEYMLP
DFEYMLQ | DFEYMLR | DFEYMLS | DFEYNJP | DFEYNJQ | DFEYNJR | DFEYNJS | DFEYNKP | DFEYNKQ | DFEYNKR | DFEYNKS
DFEYNLP | DFEYNLQ | DFEYNLR | DFEYNLS | DFEYOJP | DFEYOJQ | DFEYOJR | DFEYOJS | DFEYOKP | DFEYOKQ | DFEYOKR
DFEYOKS | DFEYOLP | DFEYOLQ | DFEYOLR | DFEYOLS | DFEZMJP | DFEZMJQ | DFEZMJR | DFEZMJS | DFEZMKP | DFEZMKQ
DFEZMKR | DFEZMKS | DFEZMLP | DFEZMLQ | DFEZMLR | DFEZMLS | DFEZNJP | DFEZNJQ | DFEZNJR | DFEZNJS | DFEZNKP
DFEZNKQ | DFEZNKR | DFEZNKS | DFEZNLP | DFEZNLQ | DFEZNLR | DFEZNLS | DFEZOJP | DFEZOJQ | DFEZOJR | DFEZOJS
DFEZOKP | DFEZOKQ | DFEZOKR | DFEZOKS | DFEZOLP | DFEZOLQ | DFEZOLR | DFEZOLS | DFFWMJP | DFFWMJQ | DFFWMJR
DFFWMJS | DFFWMKP | DFFWMKQ | DFFWMKR | DFFWMKS | DFFWMLP | DFFWMLQ | DFFWMLR | DFFWMLS | DFFWNJP | DFFWNJQ
DFFWNJR | DFFWNJS | DFFWNKP | DFFWNKQ | DFFWNKR | DFFWNKS | DFFWNLP | DFFWNLQ | DFFWNLR | DFFWNLS | DFFWOJP
DFFWOJQ | DFFWOJR | DFFWOJS | DFFWOKP | DFFWOKQ | DFFWOKR | DFFWOKS | DFFWOLP | DFFWOLQ | DFFWOLR | DFFWOLS
DFFXMJP | DFFXMJQ | DFFXMJR | DFFXMJS | DFFXMKP | DFFXMKQ | DFFXMKR | DFFXMKS | DFFXMLP | DFFXMLQ | DFFXMLR
DFFXMLS | DFFXNJP | DFFXNJQ | DFFXNJR | DFFXNJS | DFFXNKP | DFFXNKQ | DFFXNKR | DFFXNKS | DFFXNLP | DFFXNLQ
DFFXNLR | DFFXNLS | DFFXOJP | DFFXOJQ | DFFXOJR | DFFXOJS | DFFXOKP | DFFXOKQ | DFFXOKR | DFFXOKS | DFFXOLP
DFFXOLQ | DFFXOLR | DFFXOLS | DFFYMJP | DFFYMJQ | DFFYMJR | DFFYMJS | DFFYMKP | DFFYMKQ | DFFYMKR | DFFYMKS
DFFYMLP | DFFYMLQ | DFFYMLR | DFFYMLS | DFFYNJP | DFFYNJQ | DFFYNJR | DFFYNJS | DFFYNKP | DFFYNKQ | DFFYNKR
DFFYNKS | DFFYNLP | DFFYNLQ | DFFYNLR | DFFYNLS | DFFYOJP | DFFYOJQ | DFFYOJR | DFFYOJS | DFFYOKP | DFFYOKQ
DFFYOKR | DFFYOKS | DFFYOLP | DFFYOLQ | DFFYOLR | DFFYOLS | DFFZMJP | DFFZMJQ | DFFZMJR | DFFZMJS | DFFZMKP
DFFZMKQ | DFFZMKR | DFFZMKS | DFFZMLP | DFFZMLQ | DFFZMLR | DFFZMLS | DFFZNJP | DFFZNJQ | DFFZNJR | DFFZNJS
DFFZNKP | DFFZNKQ | DFFZNKR | DFFZNKS | DFFZNLP | DFFZNLQ | DFFZNLR | DFFZNLS | DFFZOJP | DFFZOJQ | DFFZOJR
DFFZOJS | DFFZOKP | DFFZOKQ | DFFZOKR | DFFZOKS | DFFZOLP | DFFZOLQ | DFFZOLR | DFFZOLS | EDDWMJP | EDDWMJQ
EDDWMJR | EDDWMJS | EDDWMKP | EDDWMKQ | EDDWMKR | EDDWMKS | EDDWMLP | EDDWMLQ | EDDWMLR | EDDWMLS | EDDWNJP
EDDWNJQ | EDDWNJR | EDDWNJS | EDDWNKP | EDDWNKQ | EDDWNKR | EDDWNKS | EDDWNLP | EDDWNLQ | EDDWNLR | EDDWNLS
EDDWOJP | EDDWOJQ | EDDWOJR | EDDWOJS | EDDWOKP | EDDWOKQ | EDDWOKR | EDDWOKS | EDDWOLP | EDDWOLQ | EDDWOLR
EDDWOLS | EDDXMJP | EDDXMJQ | EDDXMJR | EDDXMJS | EDDXMKP | EDDXMKQ | EDDXMKR | EDDXMKS | EDDXMLP | EDDXMLQ
EDDXMLR | EDDXMLS | EDDXNJP | EDDXNJQ | EDDXNJR | EDDXNJS | EDDXNKP | EDDXNKQ | EDDXNKR | EDDXNKS | EDDXNLP
EDDXNLQ | EDDXNLR | EDDXNLS | EDDXOJP | EDDXOJQ | EDDXOJR | EDDXOJS | EDDXOKP | EDDXOKQ | EDDXOKR | EDDXOKS
EDDXOLP | EDDXOLQ | EDDXOLR | EDDXOLS | EDDYMJP | EDDYMJQ | EDDYMJR | EDDYMJS | EDDYMKP | EDDYMKQ | EDDYMKR
EDDYMKS | EDDYMLP | EDDYMLQ | EDDYMLR | EDDYMLS | EDDYNJP | EDDYNJQ | EDDYNJR | EDDYNJS | EDDYNKP | EDDYNKQ
EDDYNKR | EDDYNKS | EDDYNLP | EDDYNLQ | EDDYNLR | EDDYNLS | EDDYOJP | EDDYOJQ | EDDYOJR | EDDYOJS | EDDYOKP
EDDYOKQ | EDDYOKR | EDDYOKS | EDDYOLP | EDDYOLQ | EDDYOLR | EDDYOLS | EDDZMJP | EDDZMJQ | EDDZMJR | EDDZMJS
EDDZMKP | EDDZMKQ | EDDZMKR | EDDZMKS | EDDZMLP | EDDZMLQ | EDDZMLR | EDDZMLS | EDDZNJP | EDDZNJQ | EDDZNJR
EDDZNJS | EDDZNKP | EDDZNKQ | EDDZNKR | EDDZNKS | EDDZNLP | EDDZNLQ | EDDZNLR | EDDZNLS | EDDZOJP | EDDZOJQ
EDDZOJR | EDDZOJS | EDDZOKP | EDDZOKQ | EDDZOKR | EDDZOKS | EDDZOLP | EDDZOLQ | EDDZOLR | EDDZOLS | EDEWMJP
EDEWMJQ | EDEWMJR | EDEWMJS | EDEWMKP | EDEWMKQ | EDEWMKR | EDEWMKS | EDEWMLP | EDEWMLQ | EDEWMLR | EDEWMLS
EDEWNJP | EDEWNJQ | EDEWNJR | EDEWNJS | EDEWNKP | EDEWNKQ | EDEWNKR | EDEWNKS | EDEWNLP | EDEWNLQ | EDEWNLR
EDEWNLS | EDEWOJP | EDEWOJQ | EDEWOJR | EDEWOJS | EDEWOKP | EDEWOKQ | EDEWOKR | EDEWOKS | EDEWOLP | EDEWOLQ
EDEWOLR | EDEWOLS | EDEXMJP | EDEXMJQ | EDEXMJR | EDEXMJS | EDEXMKP | EDEXMKQ | EDEXMKR | EDEXMKS | EDEXMLP
EDEXMLQ | EDEXMLR | EDEXMLS | EDEXNJP | EDEXNJQ | EDEXNJR | EDEXNJS | EDEXNKP | EDEXNKQ | EDEXNKR | EDEXNKS
EDEXNLP | EDEXNLQ | EDEXNLR | EDEXNLS | EDEXOJP | EDEXOJQ | EDEXOJR | EDEXOJS | EDEXOKP | EDEXOKQ | EDEXOKR
EDEXOKS | EDEXOLP | EDEXOLQ | EDEXOLR | EDEXOLS | EDEYMJP | EDEYMJQ | EDEYMJR | EDEYMJS | EDEYMKP | EDEYMKQ
EDEYMKR | EDEYMKS | EDEYMLP | EDEYMLQ | EDEYMLR | EDEYMLS | EDEYNJP | EDEYNJQ | EDEYNJR | EDEYNJS | EDEYNKP
EDEYNKQ | EDEYNKR | EDEYNKS | EDEYNLP | EDEYNLQ | EDEYNLR | EDEYNLS | EDEYOJP | EDEYOJQ | EDEYOJR | EDEYOJS
EDEYOKP | EDEYOKQ | EDEYOKR | EDEYOKS | EDEYOLP | EDEYOLQ | EDEYOLR | EDEYOLS | EDEZMJP | EDEZMJQ | EDEZMJR
EDEZMJS | EDEZMKP | EDEZMKQ | EDEZMKR | EDEZMKS | EDEZMLP | EDEZMLQ | EDEZMLR | EDEZMLS | EDEZNJP | EDEZNJQ
EDEZNJR | EDEZNJS | EDEZNKP | EDEZNKQ | EDEZNKR | EDEZNKS | EDEZNLP | EDEZNLQ | EDEZNLR | EDEZNLS | EDEZOJP
EDEZOJQ | EDEZOJR | EDEZOJS | EDEZOKP | EDEZOKQ | EDEZOKR | EDEZOKS | EDEZOLP | EDEZOLQ | EDEZOLR | EDEZOLS
EDFWMJP | EDFWMJQ | EDFWMJR | EDFWMJS | EDFWMKP | EDFWMKQ | EDFWMKR | EDFWMKS | EDFWMLP | EDFWMLQ | EDFWMLR
EDFWMLS | EDFWNJP | EDFWNJQ | EDFWNJR | EDFWNJS | EDFWNKP | EDFWNKQ | EDFWNKR | EDFWNKS | EDFWNLP | EDFWNLQ
EDFWNLR | EDFWNLS | EDFWOJP | EDFWOJQ | EDFWOJR | EDFWOJS | EDFWOKP | EDFWOKQ | EDFWOKR | EDFWOKS | EDFWOLP
EDFWOLQ | EDFWOLR | EDFWOLS | EDFXMJP | EDFXMJQ | EDFXMJR | EDFXMJS | EDFXMKP | EDFXMKQ | EDFXMKR | EDFXMKS
EDFXMLP | EDFXMLQ | EDFXMLR | EDFXMLS | EDFXNJP | EDFXNJQ | EDFXNJR | EDFXNJS | EDFXNKP | EDFXNKQ | EDFXNKR
EDFXNKS | EDFXNLP | EDFXNLQ | EDFXNLR | EDFXNLS | EDFXOJP | EDFXOJQ | EDFXOJR | EDFXOJS | EDFXOKP | EDFXOKQ
EDFXOKR | EDFXOKS | EDFXOLP | EDFXOLQ | EDFXOLR | EDFXOLS | EDFYMJP | EDFYMJQ | EDFYMJR | EDFYMJS | EDFYMKP
EDFYMKQ | EDFYMKR | EDFYMKS | EDFYMLP | EDFYMLQ | EDFYMLR | EDFYMLS | EDFYNJP | EDFYNJQ | EDFYNJR | EDFYNJS
EDFYNKP | EDFYNKQ | EDFYNKR | EDFYNKS | EDFYNLP | EDFYNLQ | EDFYNLR | EDFYNLS | EDFYOJP | EDFYOJQ | EDFYOJR
EDFYOJS | EDFYOKP | EDFYOKQ | EDFYOKR | EDFYOKS | EDFYOLP | EDFYOLQ | EDFYOLR | EDFYOLS | EDFZMJP | EDFZMJQ
EDFZMJR | EDFZMJS | EDFZMKP | EDFZMKQ | EDFZMKR | EDFZMKS | EDFZMLP | EDFZMLQ | EDFZMLR | EDFZMLS | EDFZNJP
EDFZNJQ | EDFZNJR | EDFZNJS | EDFZNKP | EDFZNKQ | EDFZNKR | EDFZNKS | EDFZNLP | EDFZNLQ | EDFZNLR | EDFZNLS
EDFZOJP | EDFZOJQ | EDFZOJR | EDFZOJS | EDFZOKP | EDFZOKQ | EDFZOKR | EDFZOKS | EDFZOLP | EDFZOLQ | EDFZOLR
EDFZOLS | EEDWMJP | EEDWMJQ | EEDWMJR | EEDWMJS | EEDWMKP | EEDWMKQ | EEDWMKR | EEDWMKS | EEDWMLP | EEDWMLQ
EEDWMLR | EEDWMLS | EEDWNJP | EEDWNJQ | EEDWNJR | EEDWNJS | EEDWNKP | EEDWNKQ | EEDWNKR | EEDWNKS | EEDWNLP
EEDWNLQ | EEDWNLR | EEDWNLS | EEDWOJP | EEDWOJQ | EEDWOJR | EEDWOJS | EEDWOKP | EEDWOKQ | EEDWOKR | EEDWOKS
EEDWOLP | EEDWOLQ | EEDWOLR | EEDWOLS | EEDXMJP | EEDXMJQ | EEDXMJR | EEDXMJS | EEDXMKP | EEDXMKQ | EEDXMKR
EEDXMKS | EEDXMLP | EEDXMLQ | EEDXMLR | EEDXMLS | EEDXNJP | EEDXNJQ | EEDXNJR | EEDXNJS | EEDXNKP | EEDXNKQ
EEDXNKR | EEDXNKS | EEDXNLP | EEDXNLQ | EEDXNLR | EEDXNLS | EEDXOJP | EEDXOJQ | EEDXOJR | EEDXOJS | EEDXOKP
EEDXOKQ | EEDXOKR | EEDXOKS | EEDXOLP | EEDXOLQ | EEDXOLR | EEDXOLS | EEDYMJP | EEDYMJQ | EEDYMJR | EEDYMJS
EEDYMKP | EEDYMKQ | EEDYMKR | EEDYMKS | EEDYMLP | EEDYMLQ | EEDYMLR | EEDYMLS | EEDYNJP | EEDYNJQ | EEDYNJR
EEDYNJS | EEDYNKP | EEDYNKQ | EEDYNKR | EEDYNKS | EEDYNLP | EEDYNLQ | EEDYNLR | EEDYNLS | EEDYOJP | EEDYOJQ
EEDYOJR | EEDYOJS | EEDYOKP | EEDYOKQ | EEDYOKR | EEDYOKS | EEDYOLP | EEDYOLQ | EEDYOLR | EEDYOLS | EEDZMJP
EEDZMJQ | EEDZMJR | EEDZMJS | EEDZMKP | EEDZMKQ | EEDZMKR | EEDZMKS | EEDZMLP | EEDZMLQ | EEDZMLR | EEDZMLS
EEDZNJP | EEDZNJQ | EEDZNJR | EEDZNJS | EEDZNKP | EEDZNKQ | EEDZNKR | EEDZNKS | EEDZNLP | EEDZNLQ | EEDZNLR
EEDZNLS | EEDZOJP | EEDZOJQ | EEDZOJR | EEDZOJS | EEDZOKP | EEDZOKQ | EEDZOKR | EEDZOKS | EEDZOLP | EEDZOLQ
EEDZOLR | EEDZOLS | EEEWMJP | EEEWMJQ | EEEWMJR | EEEWMJS | EEEWMKP | EEEWMKQ | EEEWMKR | EEEWMKS | EEEWMLP
EEEWMLQ | EEEWMLR | EEEWMLS | EEEWNJP | EEEWNJQ | EEEWNJR | EEEWNJS | EEEWNKP | EEEWNKQ | EEEWNKR | EEEWNKS
EEEWNLP | EEEWNLQ | EEEWNLR | EEEWNLS | EEEWOJP | EEEWOJQ | EEEWOJR | EEEWOJS | EEEWOKP | EEEWOKQ | EEEWOKR
EEEWOKS | EEEWOLP | EEEWOLQ | EEEWOLR | EEEWOLS | EEEXMJP | EEEXMJQ | EEEXMJR | EEEXMJS | EEEXMKP | EEEXMKQ
EEEXMKR | EEEXMKS | EEEXMLP | EEEXMLQ | EEEXMLR | EEEXMLS | EEEXNJP | EEEXNJQ | EEEXNJR | EEEXNJS | EEEXNKP
EEEXNKQ | EEEXNKR | EEEXNKS | EEEXNLP | EEEXNLQ | EEEXNLR | EEEXNLS | EEEXOJP | EEEXOJQ | EEEXOJR | EEEXOJS
EEEXOKP | EEEXOKQ | EEEXOKR | EEEXOKS | EEEXOLP | EEEXOLQ | EEEXOLR | EEEXOLS | EEEYMJP | EEEYMJQ | EEEYMJR
EEEYMJS | EEEYMKP | EEEYMKQ | EEEYMKR | EEEYMKS | EEEYMLP | EEEYMLQ | EEEYMLR | EEEYMLS | EEEYNJP | EEEYNJQ
EEEYNJR | EEEYNJS | EEEYNKP | EEEYNKQ | EEEYNKR | EEEYNKS | EEEYNLP | EEEYNLQ | EEEYNLR | EEEYNLS | EEEYOJP
EEEYOJQ | EEEYOJR | EEEYOJS | EEEYOKP | EEEYOKQ | EEEYOKR | EEEYOKS | EEEYOLP | EEEYOLQ | EEEYOLR | EEEYOLS
EEEZMJP | EEEZMJQ | EEEZMJR | EEEZMJS | EEEZMKP | EEEZMKQ | EEEZMKR | EEEZMKS | EEEZMLP | EEEZMLQ | EEEZMLR
EEEZMLS | EEEZNJP | EEEZNJQ | EEEZNJR | EEEZNJS | EEEZNKP | EEEZNKQ | EEEZNKR | EEEZNKS | EEEZNLP | EEEZNLQ
EEEZNLR | EEEZNLS | EEEZOJP | EEEZOJQ | EEEZOJR | EEEZOJS | EEEZOKP | EEEZOKQ | EEEZOKR | EEEZOKS | EEEZOLP
EEEZOLQ | EEEZOLR | EEEZOLS | EEFWMJP | EEFWMJQ | EEFWMJR | EEFWMJS | EEFWMKP | EEFWMKQ | EEFWMKR | EEFWMKS
EEFWMLP | EEFWMLQ | EEFWMLR | EEFWMLS | EEFWNJP | EEFWNJQ | EEFWNJR | EEFWNJS | EEFWNKP | EEFWNKQ | EEFWNKR
EEFWNKS | EEFWNLP | EEFWNLQ | EEFWNLR | EEFWNLS | EEFWOJP | EEFWOJQ | EEFWOJR | EEFWOJS | EEFWOKP | EEFWOKQ
EEFWOKR | EEFWOKS | EEFWOLP | EEFWOLQ | EEFWOLR | EEFWOLS | EEFXMJP | EEFXMJQ | EEFXMJR | EEFXMJS | EEFXMKP
EEFXMKQ | EEFXMKR | EEFXMKS | EEFXMLP | EEFXMLQ | EEFXMLR | EEFXMLS | EEFXNJP | EEFXNJQ | EEFXNJR | EEFXNJS
EEFXNKP | EEFXNKQ | EEFXNKR | EEFXNKS | EEFXNLP | EEFXNLQ | EEFXNLR | EEFXNLS | EEFXOJP | EEFXOJQ | EEFXOJR
EEFXOJS | EEFXOKP | EEFXOKQ | EEFXOKR | EEFXOKS | EEFXOLP | EEFXOLQ | EEFXOLR | EEFXOLS | EEFYMJP | EEFYMJQ
EEFYMJR | EEFYMJS | EEFYMKP | EEFYMKQ | EEFYMKR | EEFYMKS | EEFYMLP | EEFYMLQ | EEFYMLR | EEFYMLS | EEFYNJP
EEFYNJQ | EEFYNJR | EEFYNJS | EEFYNKP | EEFYNKQ | EEFYNKR | EEFYNKS | EEFYNLP | EEFYNLQ | EEFYNLR | EEFYNLS
EEFYOJP | EEFYOJQ | EEFYOJR | EEFYOJS | EEFYOKP | EEFYOKQ | EEFYOKR | EEFYOKS | EEFYOLP | EEFYOLQ | EEFYOLR
EEFYOLS | EEFZMJP | EEFZMJQ | EEFZMJR | EEFZMJS | EEFZMKP | EEFZMKQ | EEFZMKR | EEFZMKS | EEFZMLP | EEFZMLQ
EEFZMLR | EEFZMLS | EEFZNJP | EEFZNJQ | EEFZNJR | EEFZNJS | EEFZNKP | EEFZNKQ | EEFZNKR | EEFZNKS | EEFZNLP
EEFZNLQ | EEFZNLR | EEFZNLS | EEFZOJP | EEFZOJQ | EEFZOJR | EEFZOJS | EEFZOKP | EEFZOKQ | EEFZOKR | EEFZOKS
EEFZOLP | EEFZOLQ | EEFZOLR | EEFZOLS | EFDWMJP | EFDWMJQ | EFDWMJR | EFDWMJS | EFDWMKP | EFDWMKQ | EFDWMKR
EFDWMKS | EFDWMLP | EFDWMLQ | EFDWMLR | EFDWMLS | EFDWNJP | EFDWNJQ | EFDWNJR | EFDWNJS | EFDWNKP | EFDWNKQ
EFDWNKR | EFDWNKS | EFDWNLP | EFDWNLQ | EFDWNLR | EFDWNLS | EFDWOJP | EFDWOJQ | EFDWOJR | EFDWOJS | EFDWOKP
EFDWOKQ | EFDWOKR | EFDWOKS | EFDWOLP | EFDWOLQ | EFDWOLR | EFDWOLS | EFDXMJP | EFDXMJQ | EFDXMJR | EFDXMJS
EFDXMKP | EFDXMKQ | EFDXMKR | EFDXMKS | EFDXMLP | EFDXMLQ | EFDXMLR | EFDXMLS | EFDXNJP | EFDXNJQ | EFDXNJR
EFDXNJS | EFDXNKP | EFDXNKQ | EFDXNKR | EFDXNKS | EFDXNLP | EFDXNLQ | EFDXNLR | EFDXNLS | EFDXOJP | EFDXOJQ
EFDXOJR | EFDXOJS | EFDXOKP | EFDXOKQ | EFDXOKR | EFDXOKS | EFDXOLP | EFDXOLQ | EFDXOLR | EFDXOLS | EFDYMJP
EFDYMJQ | EFDYMJR | EFDYMJS | EFDYMKP | EFDYMKQ | EFDYMKR | EFDYMKS | EFDYMLP | EFDYMLQ | EFDYMLR | EFDYMLS
EFDYNJP | EFDYNJQ | EFDYNJR | EFDYNJS | EFDYNKP | EFDYNKQ | EFDYNKR | EFDYNKS | EFDYNLP | EFDYNLQ | EFDYNLR
EFDYNLS | EFDYOJP | EFDYOJQ | EFDYOJR | EFDYOJS | EFDYOKP | EFDYOKQ | EFDYOKR | EFDYOKS | EFDYOLP | EFDYOLQ
EFDYOLR | EFDYOLS | EFDZMJP | EFDZMJQ | EFDZMJR | EFDZMJS | EFDZMKP | EFDZMKQ | EFDZMKR | EFDZMKS | EFDZMLP
EFDZMLQ | EFDZMLR | EFDZMLS | EFDZNJP | EFDZNJQ | EFDZNJR | EFDZNJS | EFDZNKP | EFDZNKQ | EFDZNKR | EFDZNKS
EFDZNLP | EFDZNLQ | EFDZNLR | EFDZNLS | EFDZOJP | EFDZOJQ | EFDZOJR | EFDZOJS | EFDZOKP | EFDZOKQ | EFDZOKR
EFDZOKS | EFDZOLP | EFDZOLQ | EFDZOLR | EFDZOLS | EFEWMJP | EFEWMJQ | EFEWMJR | EFEWMJS | EFEWMKP | EFEWMKQ
EFEWMKR | EFEWMKS | EFEWMLP | EFEWMLQ | EFEWMLR | EFEWMLS | EFEWNJP | EFEWNJQ | EFEWNJR | EFEWNJS | EFEWNKP
EFEWNKQ | EFEWNKR | EFEWNKS | EFEWNLP | EFEWNLQ | EFEWNLR | EFEWNLS | EFEWOJP | EFEWOJQ | EFEWOJR | EFEWOJS
EFEWOKP | EFEWOKQ | EFEWOKR | EFEWOKS | EFEWOLP | EFEWOLQ | EFEWOLR | EFEWOLS | EFEXMJP | EFEXMJQ | EFEXMJR
EFEXMJS | EFEXMKP | EFEXMKQ | EFEXMKR | EFEXMKS | EFEXMLP | EFEXMLQ | EFEXMLR | EFEXMLS | EFEXNJP | EFEXNJQ
EFEXNJR | EFEXNJS | EFEXNKP | EFEXNKQ | EFEXNKR | EFEXNKS | EFEXNLP | EFEXNLQ | EFEXNLR | EFEXNLS | EFEXOJP
EFEXOJQ | EFEXOJR | EFEXOJS | EFEXOKP | EFEXOKQ | EFEXOKR | EFEXOKS | EFEXOLP | EFEXOLQ | EFEXOLR | EFEXOLS
EFEYMJP | EFEYMJQ | EFEYMJR | EFEYMJS | EFEYMKP | EFEYMKQ | EFEYMKR | EFEYMKS | EFEYMLP | EFEYMLQ | EFEYMLR
EFEYMLS | EFEYNJP | EFEYNJQ | EFEYNJR | EFEYNJS | EFEYNKP | EFEYNKQ | EFEYNKR | EFEYNKS | EFEYNLP | EFEYNLQ
EFEYNLR | EFEYNLS | EFEYOJP | EFEYOJQ | EFEYOJR | EFEYOJS | EFEYOKP | EFEYOKQ | EFEYOKR | EFEYOKS | EFEYOLP
EFEYOLQ | EFEYOLR | EFEYOLS | EFEZMJP | EFEZMJQ | EFEZMJR | EFEZMJS | EFEZMKP | EFEZMKQ | EFEZMKR | EFEZMKS
EFEZMLP | EFEZMLQ | EFEZMLR | EFEZMLS | EFEZNJP | EFEZNJQ | EFEZNJR | EFEZNJS | EFEZNKP | EFEZNKQ | EFEZNKR
EFEZNKS | EFEZNLP | EFEZNLQ | EFEZNLR | EFEZNLS | EFEZOJP | EFEZOJQ | EFEZOJR | EFEZOJS | EFEZOKP | EFEZOKQ
EFEZOKR | EFEZOKS | EFEZOLP | EFEZOLQ | EFEZOLR | EFEZOLS | EFFWMJP | EFFWMJQ | EFFWMJR | EFFWMJS | EFFWMKP
EFFWMKQ | EFFWMKR | EFFWMKS | EFFWMLP | EFFWMLQ | EFFWMLR | EFFWMLS | EFFWNJP | EFFWNJQ | EFFWNJR | EFFWNJS
EFFWNKP | EFFWNKQ | EFFWNKR | EFFWNKS | EFFWNLP | EFFWNLQ | EFFWNLR | EFFWNLS | EFFWOJP | EFFWOJQ | EFFWOJR
EFFWOJS | EFFWOKP | EFFWOKQ | EFFWOKR | EFFWOKS | EFFWOLP | EFFWOLQ | EFFWOLR | EFFWOLS | EFFXMJP | EFFXMJQ
EFFXMJR | EFFXMJS | EFFXMKP | EFFXMKQ | EFFXMKR | EFFXMKS | EFFXMLP | EFFXMLQ | EFFXMLR | EFFXMLS | EFFXNJP
EFFXNJQ | EFFXNJR | EFFXNJS | EFFXNKP | EFFXNKQ | EFFXNKR | EFFXNKS | EFFXNLP | EFFXNLQ | EFFXNLR | EFFXNLS
EFFXOJP | EFFXOJQ | EFFXOJR | EFFXOJS | EFFXOKP | EFFXOKQ | EFFXOKR | EFFXOKS | EFFXOLP | EFFXOLQ | EFFXOLR
EFFXOLS | EFFYMJP | EFFYMJQ | EFFYMJR | EFFYMJS | EFFYMKP | EFFYMKQ | EFFYMKR | EFFYMKS | EFFYMLP | EFFYMLQ
EFFYMLR | EFFYMLS | EFFYNJP | EFFYNJQ | EFFYNJR | EFFYNJS | EFFYNKP | EFFYNKQ | EFFYNKR | EFFYNKS | EFFYNLP
EFFYNLQ | EFFYNLR | EFFYNLS | EFFYOJP | EFFYOJQ | EFFYOJR | EFFYOJS | EFFYOKP | EFFYOKQ | EFFYOKR | EFFYOKS
EFFYOLP | EFFYOLQ | EFFYOLR | EFFYOLS | EFFZMJP | EFFZMJQ | EFFZMJR | EFFZMJS | EFFZMKP | EFFZMKQ | EFFZMKR
EFFZMKS | EFFZMLP | EFFZMLQ | EFFZMLR | EFFZMLS | EFFZNJP | EFFZNJQ | EFFZNJR | EFFZNJS | EFFZNKP | EFFZNKQ
EFFZNKR | EFFZNKS | EFFZNLP | EFFZNLQ | EFFZNLR | EFFZNLS | EFFZOJP | EFFZOJQ | EFFZOJR | EFFZOJS | EFFZOKP
EFFZOKQ | EFFZOKR | EFFZOKS | EFFZOLP | EFFZOLQ | EFFZOLR | EFFZOLS | FDDWMJP | FDDWMJQ | FDDWMJR | FDDWMJS
FDDWMKP | FDDWMKQ | FDDWMKR | FDDWMKS | FDDWMLP | FDDWMLQ | FDDWMLR | FDDWMLS | FDDWNJP | FDDWNJQ | FDDWNJR
FDDWNJS | FDDWNKP | FDDWNKQ | FDDWNKR | FDDWNKS | FDDWNLP | FDDWNLQ | FDDWNLR | FDDWNLS | FDDWOJP | FDDWOJQ
FDDWOJR | FDDWOJS | FDDWOKP | FDDWOKQ | FDDWOKR | FDDWOKS | FDDWOLP | FDDWOLQ | FDDWOLR | FDDWOLS | FDDXMJP
FDDXMJQ | FDDXMJR | FDDXMJS | FDDXMKP | FDDXMKQ | FDDXMKR | FDDXMKS | FDDXMLP | FDDXMLQ | FDDXMLR | FDDXMLS
FDDXNJP | FDDXNJQ | FDDXNJR | FDDXNJS | FDDXNKP | FDDXNKQ | FDDXNKR | FDDXNKS | FDDXNLP | FDDXNLQ | FDDXNLR
FDDXNLS | FDDXOJP | FDDXOJQ | FDDXOJR | FDDXOJS | FDDXOKP | FDDXOKQ | FDDXOKR | FDDXOKS | FDDXOLP | FDDXOLQ
FDDXOLR | FDDXOLS | FDDYMJP | FDDYMJQ | FDDYMJR | FDDYMJS | FDDYMKP | FDDYMKQ | FDDYMKR | FDDYMKS | FDDYMLP
FDDYMLQ | FDDYMLR | FDDYMLS | FDDYNJP | FDDYNJQ | FDDYNJR | FDDYNJS | FDDYNKP | FDDYNKQ | FDDYNKR | FDDYNKS
FDDYNLP | FDDYNLQ | FDDYNLR | FDDYNLS | FDDYOJP | FDDYOJQ | FDDYOJR | FDDYOJS | FDDYOKP | FDDYOKQ | FDDYOKR
FDDYOKS | FDDYOLP | FDDYOLQ | FDDYOLR | FDDYOLS | FDDZMJP | FDDZMJQ | FDDZMJR | FDDZMJS | FDDZMKP | FDDZMKQ
FDDZMKR | FDDZMKS | FDDZMLP | FDDZMLQ | FDDZMLR | FDDZMLS | FDDZNJP | FDDZNJQ | FDDZNJR | FDDZNJS | FDDZNKP
FDDZNKQ | FDDZNKR | FDDZNKS | FDDZNLP | FDDZNLQ | FDDZNLR | FDDZNLS | FDDZOJP | FDDZOJQ | FDDZOJR | FDDZOJS
FDDZOKP | FDDZOKQ | FDDZOKR | FDDZOKS | FDDZOLP | FDDZOLQ | FDDZOLR | FDDZOLS | FDEWMJP | FDEWMJQ | FDEWMJR
FDEWMJS | FDEWMKP | FDEWMKQ | FDEWMKR | FDEWMKS | FDEWMLP | FDEWMLQ | FDEWMLR | FDEWMLS | FDEWNJP | FDEWNJQ
FDEWNJR | FDEWNJS | FDEWNKP | FDEWNKQ | FDEWNKR | FDEWNKS | FDEWNLP | FDEWNLQ | FDEWNLR | FDEWNLS | FDEWOJP
FDEWOJQ | FDEWOJR | FDEWOJS | FDEWOKP | FDEWOKQ | FDEWOKR | FDEWOKS | FDEWOLP | FDEWOLQ | FDEWOLR | FDEWOLS
FDEXMJP | FDEXMJQ | FDEXMJR | FDEXMJS | FDEXMKP | FDEXMKQ | FDEXMKR | FDEXMKS | FDEXMLP | FDEXMLQ | FDEXMLR
FDEXMLS | FDEXNJP | FDEXNJQ | FDEXNJR | FDEXNJS | FDEXNKP | FDEXNKQ | FDEXNKR | FDEXNKS | FDEXNLP | FDEXNLQ
FDEXNLR | FDEXNLS | FDEXOJP | FDEXOJQ | FDEXOJR | FDEXOJS | FDEXOKP | FDEXOKQ | FDEXOKR | FDEXOKS | FDEXOLP
FDEXOLQ | FDEXOLR | FDEXOLS | FDEYMJP | FDEYMJQ | FDEYMJR | FDEYMJS | FDEYMKP | FDEYMKQ | FDEYMKR | FDEYMKS
FDEYMLP | FDEYMLQ | FDEYMLR | FDEYMLS | FDEYNJP | FDEYNJQ | FDEYNJR | FDEYNJS | FDEYNKP | FDEYNKQ | FDEYNKR
FDEYNKS | FDEYNLP | FDEYNLQ | FDEYNLR | FDEYNLS | FDEYOJP | FDEYOJQ | FDEYOJR | FDEYOJS | FDEYOKP | FDEYOKQ
FDEYOKR | FDEYOKS | FDEYOLP | FDEYOLQ | FDEYOLR | FDEYOLS | FDEZMJP | FDEZMJQ | FDEZMJR | FDEZMJS | FDEZMKP
FDEZMKQ | FDEZMKR | FDEZMKS | FDEZMLP | FDEZMLQ | FDEZMLR | FDEZMLS | FDEZNJP | FDEZNJQ | FDEZNJR | FDEZNJS
FDEZNKP | FDEZNKQ | FDEZNKR | FDEZNKS | FDEZNLP | FDEZNLQ | FDEZNLR | FDEZNLS | FDEZOJP | FDEZOJQ | FDEZOJR
FDEZOJS | FDEZOKP | FDEZOKQ | FDEZOKR | FDEZOKS | FDEZOLP | FDEZOLQ | FDEZOLR | FDEZOLS | FDFWMJP | FDFWMJQ
FDFWMJR | FDFWMJS | FDFWMKP | FDFWMKQ | FDFWMKR | FDFWMKS | FDFWMLP | FDFWMLQ | FDFWMLR | FDFWMLS | FDFWNJP
FDFWNJQ | FDFWNJR | FDFWNJS | FDFWNKP | FDFWNKQ | FDFWNKR | FDFWNKS | FDFWNLP | FDFWNLQ | FDFWNLR | FDFWNLS
FDFWOJP | FDFWOJQ | FDFWOJR | FDFWOJS | FDFWOKP | FDFWOKQ | FDFWOKR | FDFWOKS | FDFWOLP | FDFWOLQ | FDFWOLR
FDFWOLS | FDFXMJP | FDFXMJQ | FDFXMJR | FDFXMJS | FDFXMKP | FDFXMKQ | FDFXMKR | FDFXMKS | FDFXMLP | FDFXMLQ
FDFXMLR | FDFXMLS | FDFXNJP | FDFXNJQ | FDFXNJR | FDFXNJS | FDFXNKP | FDFXNKQ | FDFXNKR | FDFXNKS | FDFXNLP
FDFXNLQ | FDFXNLR | FDFXNLS | FDFXOJP | FDFXOJQ | FDFXOJR | FDFXOJS | FDFXOKP | FDFXOKQ | FDFXOKR | FDFXOKS
FDFXOLP | FDFXOLQ | FDFXOLR | FDFXOLS | FDFYMJP | FDFYMJQ | FDFYMJR | FDFYMJS | FDFYMKP | FDFYMKQ | FDFYMKR
FDFYMKS | FDFYMLP | FDFYMLQ | FDFYMLR | FDFYMLS | FDFYNJP | FDFYNJQ | FDFYNJR | FDFYNJS | FDFYNKP | FDFYNKQ
FDFYNKR | FDFYNKS | FDFYNLP | FDFYNLQ | FDFYNLR | FDFYNLS | FDFYOJP | FDFYOJQ | FDFYOJR | FDFYOJS | FDFYOKP
FDFYOKQ | FDFYOKR | FDFYOKS | FDFYOLP | FDFYOLQ | FDFYOLR | FDFYOLS | FDFZMJP | FDFZMJQ | FDFZMJR | FDFZMJS
FDFZMKP | FDFZMKQ | FDFZMKR | FDFZMKS | FDFZMLP | FDFZMLQ | FDFZMLR | FDFZMLS | FDFZNJP | FDFZNJQ | FDFZNJR
FDFZNJS | FDFZNKP | FDFZNKQ | FDFZNKR | FDFZNKS | FDFZNLP | FDFZNLQ | FDFZNLR | FDFZNLS | FDFZOJP | FDFZOJQ
FDFZOJR | FDFZOJS | FDFZOKP | FDFZOKQ | FDFZOKR | FDFZOKS | FDFZOLP | FDFZOLQ | FDFZOLR | FDFZOLS | FEDWMJP
FEDWMJQ | FEDWMJR | FEDWMJS | FEDWMKP | FEDWMKQ | FEDWMKR | FEDWMKS | FEDWMLP | FEDWMLQ | FEDWMLR | FEDWMLS
FEDWNJP | FEDWNJQ | FEDWNJR | FEDWNJS | FEDWNKP | FEDWNKQ | FEDWNKR | FEDWNKS | FEDWNLP | FEDWNLQ | FEDWNLR
FEDWNLS | FEDWOJP | FEDWOJQ | FEDWOJR | FEDWOJS | FEDWOKP | FEDWOKQ | FEDWOKR | FEDWOKS | FEDWOLP | FEDWOLQ
FEDWOLR | FEDWOLS | FEDXMJP | FEDXMJQ | FEDXMJR | FEDXMJS | FEDXMKP | FEDXMKQ | FEDXMKR | FEDXMKS | FEDXMLP
FEDXMLQ | FEDXMLR | FEDXMLS | FEDXNJP | FEDXNJQ | FEDXNJR | FEDXNJS | FEDXNKP | FEDXNKQ | FEDXNKR | FEDXNKS
FEDXNLP | FEDXNLQ | FEDXNLR | FEDXNLS | FEDXOJP | FEDXOJQ | FEDXOJR | FEDXOJS | FEDXOKP | FEDXOKQ | FEDXOKR
FEDXOKS | FEDXOLP | FEDXOLQ | FEDXOLR | FEDXOLS | FEDYMJP | FEDYMJQ | FEDYMJR | FEDYMJS | FEDYMKP | FEDYMKQ
FEDYMKR | FEDYMKS | FEDYMLP | FEDYMLQ | FEDYMLR | FEDYMLS | FEDYNJP | FEDYNJQ | FEDYNJR | FEDYNJS | FEDYNKP
FEDYNKQ | FEDYNKR | FEDYNKS | FEDYNLP | FEDYNLQ | FEDYNLR | FEDYNLS | FEDYOJP | FEDYOJQ | FEDYOJR | FEDYOJS
FEDYOKP | FEDYOKQ | FEDYOKR | FEDYOKS | FEDYOLP | FEDYOLQ | FEDYOLR | FEDYOLS | FEDZMJP | FEDZMJQ | FEDZMJR
FEDZMJS | FEDZMKP | FEDZMKQ | FEDZMKR | FEDZMKS | FEDZMLP | FEDZMLQ | FEDZMLR | FEDZMLS | FEDZNJP | FEDZNJQ
FEDZNJR | FEDZNJS | FEDZNKP | FEDZNKQ | FEDZNKR | FEDZNKS | FEDZNLP | FEDZNLQ | FEDZNLR | FEDZNLS | FEDZOJP
FEDZOJQ | FEDZOJR | FEDZOJS | FEDZOKP | FEDZOKQ | FEDZOKR | FEDZOKS | FEDZOLP | FEDZOLQ | FEDZOLR | FEDZOLS
FEEWMJP | FEEWMJQ | FEEWMJR | FEEWMJS | FEEWMKP | FEEWMKQ | FEEWMKR | FEEWMKS | FEEWMLP | FEEWMLQ | FEEWMLR
FEEWMLS | FEEWNJP | FEEWNJQ | FEEWNJR | FEEWNJS | FEEWNKP | FEEWNKQ | FEEWNKR | FEEWNKS | FEEWNLP | FEEWNLQ
FEEWNLR | FEEWNLS | FEEWOJP | FEEWOJQ | FEEWOJR | FEEWOJS | FEEWOKP | FEEWOKQ | FEEWOKR | FEEWOKS | FEEWOLP
FEEWOLQ | FEEWOLR | FEEWOLS | FEEXMJP | FEEXMJQ | FEEXMJR | FEEXMJS | FEEXMKP | FEEXMKQ | FEEXMKR | FEEXMKS
FEEXMLP | FEEXMLQ | FEEXMLR | FEEXMLS | FEEXNJP | FEEXNJQ | FEEXNJR | FEEXNJS | FEEXNKP | FEEXNKQ | FEEXNKR
FEEXNKS | FEEXNLP | FEEXNLQ | FEEXNLR | FEEXNLS | FEEXOJP | FEEXOJQ | FEEXOJR | FEEXOJS | FEEXOKP | FEEXOKQ
FEEXOKR | FEEXOKS | FEEXOLP | FEEXOLQ | FEEXOLR | FEEXOLS | FEEYMJP | FEEYMJQ | FEEYMJR | FEEYMJS | FEEYMKP
FEEYMKQ | FEEYMKR | FEEYMKS | FEEYMLP | FEEYMLQ | FEEYMLR | FEEYMLS | FEEYNJP | FEEYNJQ | FEEYNJR | FEEYNJS
FEEYNKP | FEEYNKQ | FEEYNKR | FEEYNKS | FEEYNLP | FEEYNLQ | FEEYNLR | FEEYNLS | FEEYOJP | FEEYOJQ | FEEYOJR
FEEYOJS | FEEYOKP | FEEYOKQ | FEEYOKR | FEEYOKS | FEEYOLP | FEEYOLQ | FEEYOLR | FEEYOLS | FEEZMJP | FEEZMJQ
FEEZMJR | FEEZMJS | FEEZMKP | FEEZMKQ | FEEZMKR | FEEZMKS | FEEZMLP | FEEZMLQ | FEEZMLR | FEEZMLS | FEEZNJP
FEEZNJQ | FEEZNJR | FEEZNJS | FEEZNKP | FEEZNKQ | FEEZNKR | FEEZNKS | FEEZNLP | FEEZNLQ | FEEZNLR | FEEZNLS
FEEZOJP | FEEZOJQ | FEEZOJR | FEEZOJS | FEEZOKP | FEEZOKQ | FEEZOKR | FEEZOKS | FEEZOLP | FEEZOLQ | FEEZOLR
FEEZOLS | FEFWMJP | FEFWMJQ | FEFWMJR | FEFWMJS | FEFWMKP | FEFWMKQ | FEFWMKR | FEFWMKS | FEFWMLP | FEFWMLQ
FEFWMLR | FEFWMLS | FEFWNJP | FEFWNJQ | FEFWNJR | FEFWNJS | FEFWNKP | FEFWNKQ | FEFWNKR | FEFWNKS | FEFWNLP
FEFWNLQ | FEFWNLR | FEFWNLS | FEFWOJP | FEFWOJQ | FEFWOJR | FEFWOJS | FEFWOKP | FEFWOKQ | FEFWOKR | FEFWOKS
FEFWOLP | FEFWOLQ | FEFWOLR | FEFWOLS | FEFXMJP | FEFXMJQ | FEFXMJR | FEFXMJS | FEFXMKP | FEFXMKQ | FEFXMKR
FEFXMKS | FEFXMLP | FEFXMLQ | FEFXMLR | FEFXMLS | FEFXNJP | FEFXNJQ | FEFXNJR | FEFXNJS | FEFXNKP | FEFXNKQ
FEFXNKR | FEFXNKS | FEFXNLP | FEFXNLQ | FEFXNLR | FEFXNLS | FEFXOJP | FEFXOJQ | FEFXOJR | FEFXOJS | FEFXOKP
FEFXOKQ | FEFXOKR | FEFXOKS | FEFXOLP | FEFXOLQ | FEFXOLR | FEFXOLS | FEFYMJP | FEFYMJQ | FEFYMJR | FEFYMJS
FEFYMKP | FEFYMKQ | FEFYMKR | FEFYMKS | FEFYMLP | FEFYMLQ | FEFYMLR | FEFYMLS | FEFYNJP | FEFYNJQ | FEFYNJR
FEFYNJS | FEFYNKP | FEFYNKQ | FEFYNKR | FEFYNKS | FEFYNLP | FEFYNLQ | FEFYNLR | FEFYNLS | FEFYOJP | FEFYOJQ
FEFYOJR | FEFYOJS | FEFYOKP | FEFYOKQ | FEFYOKR | FEFYOKS | FEFYOLP | FEFYOLQ | FEFYOLR | FEFYOLS | FEFZMJP
FEFZMJQ | FEFZMJR | FEFZMJS | FEFZMKP | FEFZMKQ | FEFZMKR | FEFZMKS | FEFZMLP | FEFZMLQ | FEFZMLR | FEFZMLS
FEFZNJP | FEFZNJQ | FEFZNJR | FEFZNJS | FEFZNKP | FEFZNKQ | FEFZNKR | FEFZNKS | FEFZNLP | FEFZNLQ | FEFZNLR
FEFZNLS | FEFZOJP | FEFZOJQ | FEFZOJR | FEFZOJS | FEFZOKP | FEFZOKQ | FEFZOKR | FEFZOKS | FEFZOLP | FEFZOLQ
FEFZOLR | FEFZOLS | FFDWMJP | FFDWMJQ | FFDWMJR | FFDWMJS | FFDWMKP | FFDWMKQ | FFDWMKR | FFDWMKS | FFDWMLP
FFDWMLQ | FFDWMLR | FFDWMLS | FFDWNJP | FFDWNJQ | FFDWNJR | FFDWNJS | FFDWNKP | FFDWNKQ | FFDWNKR | FFDWNKS
FFDWNLP | FFDWNLQ | FFDWNLR | FFDWNLS | FFDWOJP | FFDWOJQ | FFDWOJR | FFDWOJS | FFDWOKP | FFDWOKQ | FFDWOKR
FFDWOKS | FFDWOLP | FFDWOLQ | FFDWOLR | FFDWOLS | FFDXMJP | FFDXMJQ | FFDXMJR | FFDXMJS | FFDXMKP | FFDXMKQ
FFDXMKR | FFDXMKS | FFDXMLP | FFDXMLQ | FFDXMLR | FFDXMLS | FFDXNJP | FFDXNJQ | FFDXNJR | FFDXNJS | FFDXNKP
FFDXNKQ | FFDXNKR | FFDXNKS | FFDXNLP | FFDXNLQ | FFDXNLR | FFDXNLS | FFDXOJP | FFDXOJQ | FFDXOJR | FFDXOJS
FFDXOKP | FFDXOKQ | FFDXOKR | FFDXOKS | FFDXOLP | FFDXOLQ | FFDXOLR | FFDXOLS | FFDYMJP | FFDYMJQ | FFDYMJR
FFDYMJS | FFDYMKP | FFDYMKQ | FFDYMKR | FFDYMKS | FFDYMLP | FFDYMLQ | FFDYMLR | FFDYMLS | FFDYNJP | FFDYNJQ
FFDYNJR | FFDYNJS | FFDYNKP | FFDYNKQ | FFDYNKR | FFDYNKS | FFDYNLP | FFDYNLQ | FFDYNLR | FFDYNLS | FFDYOJP
FFDYOJQ | FFDYOJR | FFDYOJS | FFDYOKP | FFDYOKQ | FFDYOKR | FFDYOKS | FFDYOLP | FFDYOLQ | FFDYOLR | FFDYOLS
FFDZMJP | FFDZMJQ | FFDZMJR | FFDZMJS | FFDZMKP | FFDZMKQ | FFDZMKR | FFDZMKS | FFDZMLP | FFDZMLQ | FFDZMLR
FFDZMLS | FFDZNJP | FFDZNJQ | FFDZNJR | FFDZNJS | FFDZNKP | FFDZNKQ | FFDZNKR | FFDZNKS | FFDZNLP | FFDZNLQ
FFDZNLR | FFDZNLS | FFDZOJP | FFDZOJQ | FFDZOJR | FFDZOJS | FFDZOKP | FFDZOKQ | FFDZOKR | FFDZOKS | FFDZOLP
FFDZOLQ | FFDZOLR | FFDZOLS | FFEWMJP | FFEWMJQ | FFEWMJR | FFEWMJS | FFEWMKP | FFEWMKQ | FFEWMKR | FFEWMKS
FFEWMLP | FFEWMLQ | FFEWMLR | FFEWMLS | FFEWNJP | FFEWNJQ | FFEWNJR | FFEWNJS | FFEWNKP | FFEWNKQ | FFEWNKR
FFEWNKS | FFEWNLP | FFEWNLQ | FFEWNLR | FFEWNLS | FFEWOJP | FFEWOJQ | FFEWOJR | FFEWOJS | FFEWOKP | FFEWOKQ
FFEWOKR | FFEWOKS | FFEWOLP | FFEWOLQ | FFEWOLR | FFEWOLS | FFEXMJP | FFEXMJQ | FFEXMJR | FFEXMJS | FFEXMKP
FFEXMKQ | FFEXMKR | FFEXMKS | FFEXMLP | FFEXMLQ | FFEXMLR | FFEXMLS | FFEXNJP | FFEXNJQ | FFEXNJR | FFEXNJS
FFEXNKP | FFEXNKQ | FFEXNKR | FFEXNKS | FFEXNLP | FFEXNLQ | FFEXNLR | FFEXNLS | FFEXOJP | FFEXOJQ | FFEXOJR
FFEXOJS | FFEXOKP | FFEXOKQ | FFEXOKR | FFEXOKS | FFEXOLP | FFEXOLQ | FFEXOLR | FFEXOLS | FFEYMJP | FFEYMJQ
FFEYMJR | FFEYMJS | FFEYMKP | FFEYMKQ | FFEYMKR | FFEYMKS | FFEYMLP | FFEYMLQ | FFEYMLR | FFEYMLS | FFEYNJP
FFEYNJQ | FFEYNJR | FFEYNJS | FFEYNKP | FFEYNKQ | FFEYNKR | FFEYNKS | FFEYNLP | FFEYNLQ | FFEYNLR | FFEYNLS
FFEYOJP | FFEYOJQ | FFEYOJR | FFEYOJS | FFEYOKP | FFEYOKQ | FFEYOKR | FFEYOKS | FFEYOLP | FFEYOLQ | FFEYOLR
FFEYOLS | FFEZMJP | FFEZMJQ | FFEZMJR | FFEZMJS | FFEZMKP | FFEZMKQ | FFEZMKR | FFEZMKS | FFEZMLP | FFEZMLQ
FFEZMLR | FFEZMLS | FFEZNJP | FFEZNJQ | FFEZNJR | FFEZNJS | FFEZNKP | FFEZNKQ | FFEZNKR | FFEZNKS | FFEZNLP
FFEZNLQ | FFEZNLR | FFEZNLS | FFEZOJP | FFEZOJQ | FFEZOJR | FFEZOJS | FFEZOKP | FFEZOKQ | FFEZOKR | FFEZOKS
FFEZOLP | FFEZOLQ | FFEZOLR | FFEZOLS | FFFWMJP | FFFWMJQ | FFFWMJR | FFFWMJS | FFFWMKP | FFFWMKQ | FFFWMKR
FFFWMKS | FFFWMLP | FFFWMLQ | FFFWMLR | FFFWMLS | FFFWNJP | FFFWNJQ | FFFWNJR | FFFWNJS | FFFWNKP | FFFWNKQ
FFFWNKR | FFFWNKS | FFFWNLP | FFFWNLQ | FFFWNLR | FFFWNLS | FFFWOJP | FFFWOJQ | FFFWOJR | FFFWOJS | FFFWOKP
FFFWOKQ | FFFWOKR | FFFWOKS | FFFWOLP | FFFWOLQ | FFFWOLR | FFFWOLS | FFFXMJP | FFFXMJQ | FFFXMJR | FFFXMJS
FFFXMKP | FFFXMKQ | FFFXMKR | FFFXMKS | FFFXMLP | FFFXMLQ | FFFXMLR | FFFXMLS | FFFXNJP | FFFXNJQ | FFFXNJR
FFFXNJS | FFFXNKP | FFFXNKQ | FFFXNKR | FFFXNKS | FFFXNLP | FFFXNLQ | FFFXNLR | FFFXNLS | FFFXOJP | FFFXOJQ
FFFXOJR | FFFXOJS | FFFXOKP | FFFXOKQ | FFFXOKR | FFFXOKS | FFFXOLP | FFFXOLQ | FFFXOLR | FFFXOLS | FFFYMJP
FFFYMJQ | FFFYMJR | FFFYMJS | FFFYMKP | FFFYMKQ | FFFYMKR | FFFYMKS | FFFYMLP | FFFYMLQ | FFFYMLR | FFFYMLS
FFFYNJP | FFFYNJQ | FFFYNJR | FFFYNJS | FFFYNKP | FFFYNKQ | FFFYNKR | FFFYNKS | FFFYNLP | FFFYNLQ | FFFYNLR
FFFYNLS | FFFYOJP | FFFYOJQ | FFFYOJR | FFFYOJS | FFFYOKP | FFFYOKQ | FFFYOKR | FFFYOKS | FFFYOLP | FFFYOLQ
FFFYOLR | FFFYOLS | FFFZMJP | FFFZMJQ | FFFZMJR | FFFZMJS | FFFZMKP | FFFZMKQ | FFFZMKR | FFFZMKS | FFFZMLP
FFFZMLQ | FFFZMLR | FFFZMLS | FFFZNJP | FFFZNJQ | FFFZNJR | FFFZNJS | FFFZNKP | FFFZNKQ | FFFZNKR | FFFZNKS
FFFZNLP | FFFZNLQ | FFFZNLR | FFFZNLS | FFFZOJP | FFFZOJQ | FFFZOJR | FFFZOJS | FFFZOKP | FFFZOKQ | FFFZOKR
FFFZOKS | FFFZOLP | FFFZOLQ | FFFZOLR | FFFZOLS | 